#+-----------+#+-----------+#########
#|...........|#|...........|#########
#|...........|#|...........|#########
#+---#-------+#+-----#-----+#########
#####################################
#+----#--------------------------#-+#
#|.................................|#
#|.................................|#
#|......+---------------+..........|#
#|......|               |..........|#
#|......|               |..........|#
#|......+---------------+..........|#
#|.................................|#
#+---------------------------------+#
